                                                                      *                                                                                                                                                                                                                                                              %
                          &                                                                                                                                                                                                                                                                                                          %
                                                                                                                                                                                                                                                                                                                                     %
                                                                                                                                                                                                                                                                                                                                     %
                                                                                                                                                                                                                                                                                                                                     %
                                                                                                                               >                                                                                                                                                                                                   l %
                               G                                     %                                               %                                                                                        %BBB%CC                                                                                                             tuv%
                             QQQ                                     %                                               %                                                C C                                                                                                               C                                         wxy%
                                                                  K                                                                                                                                                 K                                                                                                        %%%% wxy%
                                             %%                                           C C                          %                                                                                                                                       J                                                                  wxy%
                         J                   %%     %%       %%%BBB     BBB%%%                              <          %                                                                                      %QQQBB%                                                                   J                   J          %%%%%      wxy%
                                                    %%                                                                    J                             Gtuv          Q W                                                                                     tuv            tuv                                                  wxy%
                        tuv                                                               tuv                                                           %wxy%                                       %%   %%                    %%   %%    %%    %%    %%    %%wxyCC          wxy       tuv       %%%%      tuv   %%%%%            wxy%
                        wxy                                          %                    wxy        <                   tuv                          G%%wxy%%                 %%                   %CCCCC%                    %CCCCC%                %      %wxy            wxy       wxy                 wxy                    wxy%
                        wxy          G                             G %                    wxy                      M     wxy                          %%%wxy%%%                 %%     M         G  %CCCC %                 G  %CCCCC%           G    %      %wxy            wxy       wxy                 wxy               G    wxy%
333333333333333333333333333333333333336     53333333333333333333333333333333336       533333333336                 533333333336     533333333333333333336wxy536  536  536  536  536  53333333333333333333333333333333333333333333333333333333333333333333333333333333333333333333333333333333336      5333333333333333333333333333333%
44444444444444444444444444444444444444h     g444444444444444444444444444444444h       g4444444444h[[[[[[[[[[[[[[[[[g4444444444h[[[[[g4444444444444444444hwxyg4h  g4h  g4h  g4h  g4h  g444444444444444444444444444444444444444444444444444444444444444444444444444444444444444444444444444444444h      g444444444444444444444444444444%
44444444444444444444444444444444444444h     g444444444444444444444444444444444h       g4444444444h]]]]]]]]]]]]]]]]]g4444444444h]]]]]g4444444444444444444hwxyg4h  g4h  g4h  g4h  g4h  g444444444444444444444444444444444444444444444444444444444444444444444444444444444444444444444444444444444h      g444444444444444444444444444444%
#background=0
